........................................................................................................................
0......................................................................................................................0
0......................................................................................................................0
0..............................................................................................................111111110
0......................................................................................................................0
0......................................................................................................................0
0......................................................................................................................0
0................................................111111.............................11111111111111.....................0
0..................1111111.............................................................................................0
0......................................................................................................................0
0................................11111111...............................111111111......................................0
0......................................................................................................................0
0....................1111111....................................111111.................................................0
0......................................................................................................................0
0..........111111...............11111111...............111111111.......................................................0
0.....................................................................11111111.........................................0
0..................1111............................111111111...............................11111111111.................0
0......................................................................................................................0
0.........................1111111............111111.............................1111111111........................D....0
0.P....................................................................................................................0
111111111111111111111111111111111111111111111111111111111111111111111111111111111111111111111111111111111111111111111111
